
 
         NO ./textures/test2.xpm    
SO ./textures/south.xpm




WE ./textures/west.xpm
EA ./textures/east.xpm

           F 220,100,0
       C          225,30,0

11111111111111111111
10001000000000001001
10001000000000001001
10011011101010111001
10000000100000000001
10000000100000001001
1000S000100000001001
10001000100000001001
10000000000001111001
11111000000001000001
10000000000001000001
11111111111111111111