
 
         NO ./textures/north.xpm    
SO ./textures/south.xpm




WE ./textures/west.xpm
EA ./textures/east.xpm

           F 220,100,0
       C          225,30,0

      11111111111
      10000000001
      10000000001
      10000000001
      10000000001
      10000000001
11111111111D11111111111
10000100000000001000001
10000d0000000000D000001
10000100000000001000001
10000100000000001000001
10000100000W00001000001
10000100000000001000001
10000100000000001000001
10000100000000001000001
10000D0000000000d000001
10000100000000001000001
11111111111D1111111111
      100000000001
      100000000001
      100000000001
      100000000001
      111111111111

