
 
         NO ./textures/north.xpm    
SO ./textures/south.xpm




WE ./textures/west.xpm
EA ./textures/east.xpm

           F 020,220,20
       C          225,20,220

        1111111111111111111111111
        1000000000110000000000001
        1111111110000000000000001
        1011000001110000N01000001
        100100000d000000000000001
111111111011000001110000001000001
10000000001100000111011111D111111
11110111111111011100000010101
11110111111111011101010010001
11100000110101011100000010001
10D01000000000001100000010001
10100000000000001101010010011
11D000011101010111110111100111
11110111 11101010101111010001
11111111 11111111111111111111

