
 
         NO ./textures/north.xpm    
SO ./textures/south.xpm




WE ./textures/west.xpm
EA ./textures/east.xpm

           F 220,100,170
       C          125,90,0

1111111111111111111 
10000000000000000001
1000000101D101010001
10000000010101010001
10000000000000000001
10000000000000000001
100100000000N1000001
10000000000000100001
10000000000000000001
11111000000001000001
10000000000001000001
11111111111111111111