
 
         NO ./textures/north.xpm    
SO ./textures/south.xpm




WE ./textures/west.xpm
EA ./textures/east.xpm

           F 220,100,0
       C          225,30,0

       1
        1111111111111111111111111
        1000000000110000000000001        11
        1011000001110000001000001        101
        100100000d000000000000001         1
111111111011000001110000000000001
10000000001100000111011111D111111
11110111111111011100000010001
11110111111111011101010010001
11100000110101011100000010001
10D01000000000001100000010001
10100000000000001101010010001
11D00001110101011111011110N0111
11110111 1110101 101111010001
11111111 1111111 111111111111

